Aldgate => Aldgate Station
Aldgate East => Aldgate East Station
All Saints => All Saints Station
Alperton => Alperton Station
Amersham => Amersham Station
Angel => Angel Station
Archway => Archway Station
Arnos Grove => Arnos Grove Station
Arsenal => Arsenal Station
Baker Street => Baker Street Station
Balham => Balham Station
Bank => Bank Station
Barbican => Barbican Station
Barking => Barking Station
Barkingside => Barkingside Station
Barons Court => Barons Court Station
Bayswater => Bayswater Station
Beckton => Beckton Station
Beckton Park => Beckton Park Station
Becontree => Becontree Station
Belsize Park => Belsize Park Station
Bermondsey => Bermondsey Station
Bethnal Green => Bethnal Green Station
Blackfriars => Blackfriars Station
Blackhorse Road => Blackhorse Road Station
Blackwall => Blackwall Station
Bond Street => Bond Street Station
Borough => Borough Station
Boston Manor => Boston Manor Station
Bounds Green => Bounds Green Station
Bow Church => Bow Church Station
Bow Road => Bow Road Station
Brent Cross => Brent Cross Station
Brixton => Brixton Station
Bromley By Bow => Bromley-By-Bow Station
Buckhurst Hill => Buckhurst Hill Station
Burnt Oak => Burnt Oak Station
Caledonian Road => Caledonian Road Station
Camden Town => Camden Town Station
Canada Water => Canada Water Station
Canary Wharf => Canary Wharf Station
Canning Town => Canning Town Station
Cannon Street => Cannon Street Station
Canons Park => Canons Park Station
Chalfont & Latimer => Chalfont & Latimer Station
Chalk Farm => Chalk Farm Station
Chancery Lane => Chancery Lane Station
Charing Cross => Charing Cross Station
Chesham => Chesham Station
Chigwell => Chigwell Station
Chiswick Park => Chiswick Park Station
Chorleywood => Chorleywood Station
Clapham Common => Clapham Common Station
Clapham North => Clapham North Station
Clapham South => Clapham South Station
Cockfosters => Cockfosters Station
Colindale => Colindale Station
Colliers Wood => Colliers Wood Station
Covent Garden => Covent Garden Station
Crossharbour => Crossharbour & London Arena Station
Croxley => Croxley Station
Custom House DLR => Custom House Station
Cutty Sark => Cutty Sark Station
Cyprus => Cyprus Station
Dagenham East => Dagenham East Station
Dagenham Heathway => Dagenham Heathway Station
Debden => Debden Station
Deptford Bridge => Deptford Bridge Station
Devons Road => Devons Road Station
Dollis Hill => Dollis Hill Station
Ealing Broadway => Ealing Broadway Station
Ealing Common => Ealing Common Station
Earls Court => Earl's Court Station
East Acton => East Acton Station
East Finchley => East Finchley Station
East Ham => East Ham Station
East India => East India Station
East Putney => East Putney Station
Eastcote => Eastcote Station
Edgware => Edgware Station
Edgware Road B => Edgware Road Bakerloo Station
Edgware Road M => Edgware Road Circle Station
Elephant & Castle => Elephant & Castle Station
Elm Park => Elm Park Station
Elverson Road => Elverson Road Station
Embankment => Embankment Station
Epping => Epping Station
Euston => Euston Station
Euston Square => Euston Square Station
Fairlop => Fairlop Station
Farringdon => Farringdon Station
Finchley Central => Finchley Central Station
Finchley Road => Finchley Road Station
Finsbury Park => Finsbury Park Station
Fulham Broadway => Fulham Broadway Station
Gallions Reach => Gallions Reach Station
Gants Hill => Gants Hill Station
Gloucester Road => Gloucester Road Station
Golders Green => Golders Green Station
Goldhawk Road => Goldhawk Road Station
Goodge Street => Goodge Street Station
Grange Hill => Grange Hill Station
Great Portland St => Great Portland Street Station
Green Park => Green Park Station
Greenford => Greenford Station
Greenwich DLR => Greenwich Station
Gunnersbury => Gunnersbury Station
Hainault => Hainault Station
Hammersmith D => Hammersmith (D & P) Station
Hammersmith M => Hammersmith Station
Hampstead => Hampstead Station
Hanger Lane => Hanger Lane Station
Harlesden => Harlesden Station
Harrow On The Hill => Harrow on the Hill Station
Harrow Wealdstone => Harrow & Wealdstone Station
Hatton Cross => Hatton Cross Station
Heathrow Term 4 => Heathrow Terminal 4 Station
Heathrow Term 5 => Heathrow Terminal 5 Station
Heathrow Terms 123 => Heathrow Terminals 1, 2, 3 Station
Hendon Central => Hendon Central Station
Heron Quays => Heron Quays Station
High Barnet => High Barnet Station
High Street Kens => High Street Kensington Station
Highbury => Highbury & Islington Station
Highgate => Highgate Station
Hillingdon => Hillingdon Station
Holborn => Holborn Station
Holland Park => Holland Park Station
Holloway Road => Holloway Road Station
Hornchurch => Hornchurch Station
Hounslow Central => Hounslow Central Station
Hounslow East => Hounslow East Station
Hounslow West => Hounslow West Station
Hyde Park Corner => Hyde Park Corner Station
Ickenham => Ickenham Station
Island Gardens => Island Gardens Station
Kennington => Kennington Station
Kensal Green => Kensal Green Station
Kensington Olympia => Kensington (Olympia) Station
Kentish Town => Kentish Town Station
Kenton => Kenton Station
Kew Gardens => Kew Gardens Station
Kilburn => Kilburn Station
Kilburn Park => Kilburn Park Station
King George V => King George V Station
Kings Cross => King's Cross St. Pancras Station
Kingsbury => Kingsbury Station
Knightsbridge => Knightsbridge Station
Ladbroke Grove => Ladbroke Grove Station
Lambeth North => Lambeth North Station
Lancaster Gate => Lancaster Gate Station
Latimer Road => Latimer Road Station
Leicester Square => Leicester Square Station
Lewisham DLR => Lewisham Station
Leyton => Leyton Station
Leytonstone => Leytonstone Station
Limehouse DLR => Limehouse Station
Liverpool Street => Liverpool Street Station
London Bridge => London Bridge Station
London City Airport => London City Airport Station
Loughton => Loughton Station
Maida Vale => Maida Vale Station
Manor House => Manor House Station
Mansion House => Mansion House Station
Marble Arch => Marble Arch Station
Marylebone => Marylebone Station
Mile End => Mile End Station
Mill Hill East => Mill Hill East Station
Monument => Monument Station
Moor Park => Moor Park Station
Moorgate => Moorgate Station
Morden => Morden Station
Mornington Crescent => Mornington Crescent Station
Mudchute => Mudchute Station
Neasden => Neasden Station
Newbury Park => Newbury Park Station
North Acton => North Acton Station
North Ealing => North Ealing Station
North Greenwich => North Greenwich Station
North Harrow => North Harrow Station
North Wembley => North Wembley Station
Northfields => Northfields Station
Northolt => Northolt Station
Northwick Park => Northwick Park Station
Northwood => Northwood Station
Northwood Hills => Northwood Hills Station
Notting Hill Gate => Notting Hill Gate Station
Oakwood => Oakwood Station
Old Street => Old Street Station
Osterley => Osterley Station
Oval => Oval Station
Oxford Circus => Oxford Circus Station
Paddington => Paddington Station
Park Royal => Park Royal Station
Parsons Green => Parsons Green Station
Perivale => Perivale Station
Piccadilly Circus => Piccadilly Circus Station
Pimlico => Pimlico Station
Pinner => Pinner Station
Plaistow => Plaistow Station
Pontoon Dock => Pontoon Dock Station
Poplar => Poplar Station
Preston Road => Preston Road Station
Prince Regent => Prince Regent Station
Pudding Mill Lane => Pudding Mill Lane Station
Putney Bridge => Putney Bridge Station
Queens Park => Queen's Park Station
Queensbury => Queensbury Station
Queensway => Queensway Station
Ravenscourt Park => Ravenscourt Park Station
Rayners Lane => Rayners Lane Station
Redbridge => Redbridge Station
Regents Park => Regent's Park Station
Richmond => Richmond Station
Rickmansworth => Rickmansworth Station
Roding Valley => Roding Valley Station
Royal Albert => Royal Albert Station
Royal Oak => Royal Oak Station
Royal Victoria => Royal Victoria Station
Ruislip => Ruislip Station
Ruislip Gardens => Ruislip Gardens Station
Ruislip Manor => Ruislip Manor Station
Russell Square => Russell Square Station
Seven Sisters => Seven Sisters Station
Shadwell DLR => Shadwell Station
Shepherd's Bush Mkt => Shepherd's Bush Central Station
Shepherd's Bush Und => Shepherd's Bush Hammersmith & City Station
Sloane Square => Sloane Square Station
Snaresbrook => Snaresbrook Station
South Ealing => South Ealing Station
South Harrow => South Harrow Station
South Kensington => South Kensington Station
South Kenton => South Kenton Station
South Quay => South Quay Station
South Ruislip => South Ruislip Station
South Wimbledon => South Wimbledon Station
South Woodford => South Woodford Station
Southfields => Southfields Station
Southgate => Southgate Station
Southwark => Southwark Station
St James's Park => St. James's Park Station
St Johns Wood => St. John's Wood Station
St Pauls => St. Paul's Station
Stamford Brook => Stamford Brook Station
Stanmore => Stanmore Station
Stepney Green => Stepney Green Station
Stockwell => Stockwell Station
Stonebridge Park => Stonebridge Park Station
Stratford => Stratford Station
Sudbury Hill => Sudbury Hill Station
Sudbury Town => Sudbury Town Station
Swiss Cottage => Swiss Cottage Station
Temple => Temple Station
Theydon Bois => Theydon Bois Station
Tooting Bec => Tooting Bec Station
Tooting Broadway => Tooting Broadway Station
Tottenham Court Rd => Tottenham Court Road Station
Tottenham Hale => Tottenham Hale Station
Totteridge => Totteridge & Whetstone Station
Tower Gateway => Tower Gateway Station
Tower Hill => Tower Hill Station
Tufnell Park => Tufnell Park Station
Turnham Green => Turnham Green Station
Turnpike Lane => Turnpike Lane Station
Upminster => Upminster Station
Upminster Bridge => Upminster Bridge Station
Upney => Upney Station
Upton Park => Upton Park Station
Uxbridge => Uxbridge Station
Vauxhall => Vauxhall Station
Victoria => Victoria Station
Walthamstow Central => Walthamstow Central Station
Wanstead => Wanstead Station
Warren Street => Warren Street Station
Warwick Avenue => Warwick Avenue Station
Waterloo => Waterloo Station
Watford High Street => Watford Station
Wembley Central => Wembley Central Station
Wembley Park => Wembley Park Station
West Acton => West Acton Station
West Brompton => West Brompton Station
West Finchley => West Finchley Station
West Ham => West Ham Station
West Hampstead => West Hampstead Station
West Harrow => West Harrow Station
West India Quay => West India Quay Station
West Kensington => West Kensington Station
West Ruislip => West Ruislip Station
West Silvertown => West Silvertown Station
Westbourne Park => Westbourne Park Station
Westferry => Westferry Station
Westminster => Westminster Station
White City => White City Station
Whitechapel => Whitechapel Station
Willesden Green => Willesden Green Station
Willesden Junction => Willesden Junction Station
Wimbledon => Wimbledon Station
Wimbledon Park => Wimbledon Park Station
Wood Green => Wood Green Station
Wood Lane => Wood Lane Station
Woodford => Woodford Station
Woodside Park => Woodside Park Station
Woolwich Arsenal DLR => Woolwich Arsenal Station
All: 303
